NO sprites/brick128.xpm
SO sprites/whbrick128.xpm
WE sprites/door128.xpm
EA sprites/interior128.xpm

C 200,200,200
F 0,100,100

11111111111111111
 1000000000111
 1000000000111
 1000S00000111
 1110000000001
 1110000000001
 1110000000001
11111111111111111
